111111111111111
1E0000C0000B0P1
100000000000001
111111111111111