1111111111111111111
1E10000C0000000P001
1111111111111111111