11111111
110C0001
1P100001
110000E1
11111111