11111111111111
1000000EPC00P1
1CCCCCCCCCCC0111
11111111111111
