1111111111
10PE0C00P1
1111111111
