111111111111111111111111111111111111111111111111111111111
1PCCCCCCCCCCCCCCCCCCCCCCCCCCCCCCCCCCCC0CCCCCCCCCCCCCCE111
100000000000000000000000000000000C000000000000000000000C1
111111111111111111111111111111111111111111111111111111111
